#Abbreviation	Verbose Name
Val	Valine
Leu	Leucine
Ser	Serine
Thr	Threonine
Ala	Alanine
Gly	Glycine
Hpg	Hydroxyphenylglycine
Tyr	Tyrosine
Pro	Proline
Asn	Asparigine
Ile	Isoleucine
Asp	Aspartate
Cl2-Hpg	Dichloro-Hydroxyphenylglycine
Cys	Cysteine
Glu	Glutamate
Orn	Ornithine
Gln	Glutamine
Phe	Phenylalanine
Trp	Tryptophan
Lys	Lysine
Dhpg	Dihydroxyphenylglycine
Dab	2,4-Diaminobutyric acid
bOH-Tyr	Beta-Hydroxytyrosine
OH-Orn	Hydroxyornithine
Aad	2-Aminoadipic acid
Abu	2-Aminobutyric acid
di-OH-Bz	2,3-Dihydroxybenzoic acid
Arg	Arginine
aThr	Allo-threonine
Pip	Pipecolate
D-Val	D-Valine
Ival	Isovaline
dhTyr	Dehydrotyrosine
dhAbu	2,3-Dehydroaminobutyric acid
Sal	Salicylate
D-Leu	D-Leucine
bAla	Beta-Alanine
D-Ala	D-Alanine
dhAbu	2,3-Dehydroaminobutyric acid
3Me-Asp	3-Methyl-Aspartic acid
Ac-Phe	N-Acetylphenylalanine
His	Histidine
D-Gln	D-Glutamine
D-Ser	D-Serine
Bmt	2-Butenyl-4-Methyl-Threonine
Fo-OH-Orn	L-N5-Formyl-N5-Hydroxyornithine
bLys	Beta-Lysine
NMe-Gly	Sarcosine
Fo-NMe-Orn	Formyl-N-Methyl-Hydroxyornithine
Dpr	2,3-Diaminopropionic acid
Hse	Homoserine
Dhh-Tyr	4,5-Dihydroxy-Homotyrosine
3OH-Pro	3-Hydroxyproline
3OH-Leu	3-Hydroxyleucine
Aeo	2-Amino-9,10-Epoxi-8-Oxodecanoic acid
4Me-Pro	4-Methyl-Proline
NOH-Val	N-Hydroxyvaline
3OH-Gln	3-Hydroxyglutamine
4OH-Pro	4-Hydroxyproline
D-aThr	D-allo-Threonine
3Me-Tyr	3-Methyl-Tyrosine
4OH-5OH-Orn	4,5-Dihydroxyornithine
D-Pro	D-Proline
Kyn	Kynurenine
3OH-4Me-Pro	3-Hydroxy-4-Methylproline
dh-Thr	Dehydrothreonine
3OH-3Me-Pro	3-Hydroxy-3-Methylproline
Piz	Diazinane-3-carboxylic acid
D-Trp	D-Tryptophan
D-Thr	D-Threonine
D-Dab	D-2,4-diaminobutyric acid
4p-Pro	4-Propyl-proline
33p-Ala	3-(3-Pyridyl)-Alanine
D-3OH-Leu	Beta-Hydroxy-D-Leucine
OH-cOrn	Hydroxy-Cycloornithine
Valol	Valinol
gOH-Val	Gamma-Hydroxyvaline
D-Ha	D-Hydroxyalanine
bOH-OMe-Tyr	Beta-Hydroxy-O-Methyl-Tyrosine
aOH-Gly	Alpha-Hydroxyglycine
Gca	Glycolic acid
Hiv	2-Hydroxyisovalerate
Alaol	Alaninol
PhGly	Phenylglycine
aMe-Ser	Alpha-Methylserine
D-Asn	D-Asparagine
bOH-Phe	Beta-Hydroxyphenylalanine
Nme-Thr	N-Methylthreonine
NOH-Ala	N-Hydroxylalanine
D-NOH-Ala	N-Hydroxyl-D-alanine
6Cl-Hic	6Cl-4-hydroxyindole-3-carboxylic acid
Met	Methionine
bMe-Asp	Beta-Methylaspartic acid
aIle	Allo-Isoleucine
Glyco-cya	Glycocyamine
3Me-Glu	3-Methylglutamine
Lea	Lysergic acid
ddh-Arg	4-5-dehydro-arginine
D-Cys	D-Cysteine
6Cl-Trp	6-Chloro-Tryptophan
CysA	Cysteic acid
OH-Asn	hydroxyasparagine
3OMe-Asp	3-Omethylaspartic acid
D-Lea	D-Lysergic acid
Htyr	Homotyrosine
aKiv	alpha-ketoisovaleric acid
aKic	alpha-ketoisocaproic
HOMM-Tyr	3-hydroxy-4-O-methyl-5-methyl-tyrosine
Ncp-Ala	3-nitrocyclopropyl alanine
bMe-Phe	beta methyl phenylalanine
4Pe-Pro	4-Proprenyl-proline
bMeO-Asp	Beta-methoxyaspartate
dhDab	Didehydroaminobutyric acid
OH-Asp	hydroxyaspartate
bLeu	beta-leucine
bTrp	Beta-Tryptophan
bhceAla	Beta-hydroxycyclohex‐2′‐enylalanine
Me-bAla	methyl-beta-alanine
Gac	guanidinoacetate
O-Iv	2-oxo-isovaleric acid
Hcn	Hydrocinnamate
NMe-Asp	Nmethyl-aspartate
Pac	phenylacetate
norCMA	Norcoronamic acid
Ahnpb	2-amino-3-hydroxy-4-(4-nitrophenyl)butanoate
Me-Dpr	 2,3-Diamino-3-methylpropanoic acid
3Me-Pro	3-methyl-proline